**///***
**///***
**///***
**///***
**///***
**///***
**///***
**///***
**///***************
**///**************
**//////////////////E
**//////////////////E
**//////////////////E
**********************
**********************


