**///********
**///********
**///********
**///********
**///************
**///**********
**///**********
**///**********
**///***********
**///********************
**//////////////////******
**//////////////////******
**//////////////////******
****************////****************
****************////*****************
****************////*****************
***************////////////////******
**************////////////////********
*************/////////////////*******
*******************/////////////////E
******************//////////////////E
******************//////////////////E
***************************************
***************************************