**///**
**///**
**///**
**///**
**///**
**///**
**///**
**///***
**///******************
**///******************
**//////////////////***
**//////////////////***
**//////////////////***
***************////***
***************////***
**********************************
	