**///********
**///********
**///********
**///********
**///************
**///**********
**///**********
**///**********
**///***********
**///**************
**//////////////////E
**//////////////////E
**//////////////////E
**********************
**********************
**********************

